NO assets/textures/brick_wall_1.png
SO assets/textures/brick_wall_1.png
WE assets/textures/brick_wall_1.png
EA assets/textures/brick_wall_1.png

F 1,1,1
C 1,1,1

1011
10E1
1111
