NO assets/textures/wood.xpm
SO assets/textures/wood.xpm
WE assets/textures/wood.xpm
EA assets/textures/wood.xpm

F 30,30,54
C 120,0,4



 		1111111111111111111111111
        1000000000110000000000001
        1011000001110000000000001
        1001000000000000000000001
111111111011000001110000000000001
100000000011000001110111110111111
NOO assets/textures/wood.xpm
11110111111111011100000010001
11110111111111011101010010001
11000000110101011100000000001
10000000000000001100000010001
10000000000000001101010010101
11000001110101011111011110N1111
11110111 1110101 101111010101
11111111 1111111 111111111111
